WWWWWWWWWWWWWWW
WX    F S1   2W
W W WOW WOW W W
W   O     O   W
W WOW W W WOW W
W O         O3W
WBW W W W W WwW
W             W
WOW W W W W WHW
W9O         O4W
W WOW W W WOW W
W   O     O   W
W W WOW WOW W W
W8   7f b6   5W
WWWWWWWWWWWWWWW