WWWWWWWWWWWWWWW
WX  O1    B  2W
W W W W W W W W
W   O    1O2  W
WOWOWOWOWOWOWFW
W 7 O     O 3 W
W W W W W W W W
W   f  8  O   W
W W W W W W W W
W 7 O     O 3 W
WbWOWOWOWOWOWSW
W  6O  5  O4  W
W W W W W W W W
W6  H  5  w  4W
WWWWWWWWWWWWWWW